111111
1P0C01
111111
1E0001
100001
111111